H=Hydrogen
He=Helium
Li=Lithium
Be=Beryllium
B=Boron
C=Carbon
N=Nitrogen
O=Oxygen
F=Fluorine
Ne=Neon
Na=Sodium
Mg=Magnesium
Al=Aluminum|Aluminium
Si=Silicon
P=Phosphorus
S=Sulfur
Cl=Chlorine
Ar=Argon
K=Potassium
Ca=Calcium
Ti=Titanium
Cr=Chromium
Mn=Manganese
Fe=Iron
Co=Cobalt
Ni=Nickel
Cu=Copper
Zn=Zinc
Ge=Germanium
As=Arsenic
Se=Selenium
Br=Bromine
Kr=Krypton
Rb=Rubidium
Sr=Strontium
Cd=Cadmium
Sn=Tin
Sb=Antimony
I=Iodine
Xe=Xenon
Cs=Cesium|Caesium
Ba=Barium
W=Tungsten
Pt=Platinum
Au=Gold
Hg=Mercury
Pb=Lead
Ra=Radium
U=Uranium
Pu=Plutonium
Cn=Copernicium