Albania=Tirana
Andorra=Andorra la Vella
Austria=Vienna
Belgium=Brussels
Bosnia Herzegovina=Sarajevo
Bulgaria=Sofia
Belarus=Minsk
Croatia=Zagreb
Czech Republic=Prague
Denmark=Copenhagen
Estonia=Tallinn
Finland=Helsinki
France=Paris
FYRO Macedonia=Skopje
Germany=Berlin
Greenland=Nuuk
Hungary=Budapest
Iceland=Reykjavik
Ireland=Dublin
Italy=Rome
Latvia=Riga
Lichenstein=Vaduz
Malta=Valletta
Moldova=Chisinau
Monaco=Monaco
Montenegro=Podgorica
Netherlands=Amsterdam
Norway=Oslo
Poland=Warsaw
Portugal=Lisbon
Romania=Bucharest
San Marino=San Marino
Serbia & Montenegro=Belgrade
Slovakia|slovak republic=Bratislava
Slovenia=Ljubljana
Spain=Madrid
Sweeden=Stockholm
Switzerland=Berne|bern
Ukraine=Kiev
United Kingdom=London