Antigua and Barbuda=St. John's|St Johns| St. Johns| St John's
Argentina=Buenos Aires
Bahamas=Nassau
Barbados=Bridgetown
Belize=Belmopan
Bermuda=Hamilton
Bolivia=Sucre| La Paz|sucre|lapaz|sucrelapaz
Brazil=Brasilia
Canada=Ottawa
Chile=Santiago
Columbia=Bogota
Costa Rica=San Jose
Cuba=Havana
Dominica=Roseau
Dominican Republic=Santo Domingo
Ecuador=Quito
El Salvador=San Salvador
French Guiana=Cayenne
Grenada and Carriacuou=St. George's|St Georges|St George's| St. Georges
Guatemala=Guatemala City
Guyana=Georgetown
Haiti=Port-au-Prince|Port au Prince
Honduras=Tegucigalpa
Jamaica=Kingston
Mexico=Mexico City
Nicaragua=Managua
Panama=Panama City
Paraguay=Asuncion
Peru=Lima
St. Lucia=Castries
St. Vincent and The Grenadines=Kingstown
Suriname=Paramaribo
Trinidad and Tobago=Port of Spain
Uruguay=Montevideo
United States of America=Washington D.C.|Washington DC
Venezuela=Caracas